4 4 4 4 4 4 4 4 4 4 4 4 4 4 4 4
4 6 6 6 6 6 6 6 6 6 6 6 6 6 6 4
4 6 6 6 6 6 6 6 6 6 6 6 6 6 6 4
4 6 6 6 6 6 6 6 6 6 6 6 6 6 6 4
4 6 6 6 6 3 3 3 3 3 3 6 6 6 6 4
4 6 6 6 6 3 3 3 3 3 3 6 6 6 6 4
4 6 6 6 6 6 6 6 6 6 6 6 6 6 6 4
4 6 6 6 6 6 6 6 6 6 6 6 6 6 6 4
4 6 6 6 6 6 6 6 6 6 6 6 6 6 6 4
4 4 4 4 4 4 4 4 4 4 4 4 4 4 4 4